


  NO textures/wall_1.xpm
SO     textures/wall_2.xpm


   WE             textures/wall_3.xpm
EA textures/wall_4.xpm

C 20,10,220
F 5,230,0





        1111111111111111111111111
        10E0000000110000000000001
        1011000001110000000000001111111111111111
        1001000000000000000000000000000000000001
111111111011000001110000000000001111111111111111
100000000011000001110111111111111
11110111111111011100000010001
11110111111111011101010010001
11000000110101011100000010001
10000000000000001100000010001
10000000000000001101010010001
1100000111010101111101111000111
11110111 1110101 101111010001
11111111 1111111 111111111111
